PSD95	Cytosol
GAIP	Cytosol
ABP1	Cytosol
ARIP2	Cytosol
CALRETICULIN	ER
GLYT1	Membrane
cIAP2	Cytosol
COFILIN	Cytosol
ANKYRIN	Cytosol
RYR	ER
EEF2K	Ribosomes
PKB	Cytosol
MNK1	Cytosol
DYNEIN	Cytosol
POTASSIUM	Cytosol
GABARAP	Cytosol
SYNTAXIN	Vesicles
SV2A	Vesicles
ADPRIBSYCYCLASE	Cytosol
IGF1R	Cytosol
KV42	Membrane
NWASP	Cytosol
PSD93	Cytosol
CAMKI	Cytosol
CAMKK	Cytosol
IKBA	Cytosol
S40	Ribosomes
JIP	Cytosol
COMPLEXIN	Vesicles
DREAM	Nucleus
SNAP25	Vesicles
SHANK	Cytosol
PKN	Cytosol
RICS	Cytosol
CAMKIV	Cytosol
CAMKII	Cytosol
PTEN	Cytosol
JNK	Nucleus
RASGRP3	Cytosol
SYNTENIN	Cytosol
CRIPT	Cytosol
GAP43	Cytosol
SSCAM	Cytosol
ENKEPHALIN	Extracellular
M2R	Membrane
MST3	Cytosol
TAU	Cytosol
NFM	Cytosol
NFH	Cytosol
mRNA	Ribosomes
PKCE	Cytosol
ANANDAMIDE	Extracellular
HCK	Cytosol
COOL	Cytosol
MERLIN	Cytosol
tRNA	Ribosomes
NOPR	Membrane
CBL	Cytosol
PERK	Cytosol
CBP	Nucleus
GIT1	Cytosol
NASCENTCHAIN	Ribosomes
NOS	Cytosol
DOK	Cytosol
RALBP1	Cytosol
S6	Ribosomes
RET	Membrane
XIAP	Cytosol
EPAC	Cytosol
NEUREXIN	Membrane
ADAPTIN	Cytosol
FILAMIN	Cytosol
Potassium	Cytosol
PHAS	Ribosomes
PHAP	Cytosol
CaMKI	Cytosol
MARCKS	Cytosol
EFA6	Cytosol
DOC2	Vesicles
PI3K	Cytosol
GELSOLIN	Cytosol
BETAARRESTIN	Cytosol
EIF5	Ribosomes
PP2C	Cytosol
DOPAMINE	Extracellular
LEF1	Nucleus
APOLLON	Cytosol
KIR21	Membrane
EPHRIN	Extracellular
SS	Extracellular
FIBRINOGEN	Extracellular
STEP	Cytosol
RIC	Cytosol
SSTR1	Membrane
SSTR2	Membrane
KINESIN	Cytosol
GLUTAMATE	Extracellular
CDC42	Cytosol
CAS	Cytosol
EEF1A2	Ribosomes
EGFR	Membrane
BAX	Mitochondria
YOTIAO	Cytosol
VAMP	Vesicles
BAD	Mitochondria
MITF	Nucleus
BAK	Mitochondria
CAD	Nucleus
KV41	Membrane
N41	Cytosol
PDE1B	Cytosol
PDE1A	Cytosol
FIVEHT1AR	Membrane
PP2A	Cytosol
ALPHACATENIN	Cytosol
P53	Nucleus
GRIP	Cytosol
GRIT	Cytosol
CLATHRIN	Vesicles
ABL	Cytosol
SEC61P	ER
SYNAPTOBREVIN	Vesicles
CPI17	Cytosol
TUBULIN	Cytosol
SYNAPSIN	Vesicles
IKBB	Cytosol
RSK	Cytosol
MLK3	Cytosol
D3R	Membrane
PDE1C	Cytosol
NCK	Cytosol
CEK1	Cytosol
cADPR	Cytosol
EEF2	Ribosomes
AXIN	Cytosol
CAVEOLIN	Cytosol
AP2	Vesicles
AP1	Nucleus
IP3	Cytosol
ADENOSINE	Extracellular
SIAH	Cytosol
EGF	Extracellular
FIVEHT2AR	Membrane
RAC	Cytosol
PABP	Ribosomes
VAV	Cytosol
RAL	Cytosol
PAXILLIN	Cytosol
RAI	Cytosol
SURVIVIN	Cytosol
BR1R	Membrane
CORTACTIN	Cytosol
RAS	Cytosol
RB	Nucleus
FADD	Cytosol
CAMKPASE	Cytosol
SAPAP	Cytosol
ROCK	Cytosol
LAMINA	Nucleus
INSULIN	Extracellular
CSP	Cytosol
APS	Cytosol
C3G	Cytosol
KAR	Membrane
ELK1	Nucleus
RHO	Cytosol
GRB10	Cytosol
APC	Cytosol
STAT	Nucleus
GALPHAO	Cytosol
GALPHAI	Cytosol
KSR	Cytosol
cAMP	Cytosol
TBR1	Nucleus
CAPRI	Cytosol
GRP94	ER
GALPHAZ	Cytosol
GALPHAQ	Cytosol
GALPHAS	Cytosol
PKR	Cytosol
DAPK	Cytosol
cIAP1	Cytosol
PQCaCh	Membrane
MSK1	Cytosol
PKC	Cytosol
PKA	Cytosol
PKG	Cytosol
PKD	Cytosol
CAIN	Cytosol
PKI	Cytosol
GSK3	Cytosol
PDE5A	Cytosol
CLIP170	Cytosol
IGF1	Extracellular
CSK	Cytosol
DLK	Cytosol
CERAMIDE	Cytosol
GAT1	Membrane
SHC	Cytosol
EIF4E	Ribosomes
PMCA	Membrane
EIF4G	Ribosomes
EIF4A	Ribosomes
YES	Cytosol
EIF4B	Ribosomes
CIPP	Cytosol
dATP	Cytosol
LARG	Cytosol
CREM	Nucleus
DGK	Cytosol
RADIXIN	Cytosol
CREB	Nucleus
FRIZZLED	Membrane
GKAP	Cytosol
SYNDECAN	Membrane
L1	Membrane
M1R	Membrane
CALBRAIN	Cytosol
PAFR	Membrane
P1433	Cytosol
SEK	Cytosol
pGC	Membrane
NEURABIN	Cytosol
ARFGAP	Vesicles
GALPHA12	Cytosol
GALPHA13	Cytosol
PDI	ER
GALPHA11	Cytosol
CALPAIN	Cytosol
NEUROLIGIN	Membrane
SPAL	Cytosol
RHOGEF	Cytosol
IRS1	Cytosol
IRS2	Cytosol
PTPA	Cytosol
FIBRONECTIN	Extracellular
SYNAPTOTAGMIN	Vesicles
CDK5	Cytosol
MAPK	Cytosol
RABGDI	Cytosol
ARNO	Cytosol
ALPHA7NACHR	Membrane
RALGDS	Cytosol
BIM	Mitochondria
CALMODULIN	Cytosol
BIK	Cytosol
BID	Cytosol
CAMP	Cytosol
FYN	Cytosol
MEK3	Cytosol
MEK2	Cytosol
MEK1	Cytosol
MEK7	Cytosol
MEK6	Cytosol
MEK4	Cytosol
ERBB	Membrane
RACK	Cytosol
BIP	ER
SNAPIN	Vesicles
CASPASE6	Cytosol
CASPASE7	Cytosol
CASPASE3	Cytosol
AKAP15	Cytosol
MLK	Cytosol
CASPASE8	Cytosol
CASPASE9	Cytosol
VASP	Cytosol
ICAD	Cytosol
DOPR	Membrane
AKAP	Cytosol
GLYR	Membrane
NRG	Extracellular
MEKK4	Cytosol
PRK2	Cytosol
MTOR	Cytosol
BCL2	Mitochondria
MUSK	Cytosol
NEUROFIBROMIN	Cytosol
CITRON	Cytosol
PTP1B	Cytosol
TUBERIN	Cytosol
IQGAP	Cytosol
SIVA1	Cytosol
PTP1D	Cytosol
MALS	Cytosol
MGLUR5	Membrane
MGLUR7	Membrane
MGLUR1	Membrane
PAF	Extracellular
TAMALIN	Cytosol
PAK	Cytosol
SMACDIABLO	Mitochondria
M4R	Membrane
CB2R	Membrane
RIN	Cytosol
DYRK	Cytosol
RIM	Vesicles
STARGAZIN	Cytosol
ENDOPHILIN	Vesicles
SAP97	Cytosol
VRK1	Cytosol
GEPHYRIN	Membrane
MYOSINV	Cytosol
PRMT1	Cytosol
NAIP	Cytosol
P35611	Cytosol
MDM2	Nucleus
PDE4C	Cytosol
RASGAP	Cytosol
NIK	Cytosol
PYK2	Cytosol
BETA2AR	Membrane
ARFGEF	Vesicles
SYK	Cytosol
NFKB	Nucleus
bARK	Cytosol
EPHB2	Membrane
DNAPK	Nucleus
CARM1	Nucleus
GAB1	Cytosol
CRE	Nucleus
SORCIN	Cytosol
CRK	Cytosol
NMDAR	Membrane
RABPHILIN	Vesicles
S6K	Cytosol
PLCGAMMA	Cytosol
ADDUCIN	Cytosol
CASKIN	Vesicles
TIAM1	Cytosol
PA	Cytosol
WNT	Extracellular
TCF	Nucleus
HOMER	Cytosol
MAP1A	Cytosol
MAP1B	Cytosol
ICA512	Membrane
INHIBITOR2	Cytosol
LIMK	Cytosol
S60	Ribosomes
SHPTP2	Cytosol
MOR	Cytosol
ANP	Extracellular
LCK	Cytosol
GABA	Extracellular
BAG1	Cytosol
VINCULIN	Cytosol
ILK	Cytosol
VDAC2	Mitochondria
FIVEHT4R	Membrane
RAF1	Cytosol
STAT5	Nucleus
SYNGAP	Cytosol
STAT1	Nucleus
PDE3A	Cytosol
AMISYN	Vesicles
CASK	Cytosol
PDE3B	Cytosol
P38	Cytosol
SPROUTY	Cytosol
SAM68	Cytosol
CHLORIDE	Cytosol
PLCBETA	Cytosol
FIVEHT1CR	Membrane
SYNTROPHIN	Cytosol
SRC	Cytosol
cAMPGEFII	Cytosol
MUNC13	Vesicles
SPINOPHILIN	Cytosol
SRE	Nucleus
MUNC18	Vesicles
MYOSIN	Cytosol
NTYPECA	Membrane
CGMP	Cytosol
D1R	Membrane
PLD	Cytosol
ERBIN	Cytosol
PDE4A	Cytosol
PDE4B	Cytosol
RHEB	Cytosol
PDE4D	Cytosol
MKP1	Cytosol
EIF2	Ribosomes
EIF3	Ribosomes
CHAPSYN110	Cytosol
MKP5	Cytosol
MAP2	Cytosol
CALCIUM	Cytosol
KIR23	Membrane
MOPR	Membrane
PIN1	Nucleus
ALPHA1AR	Membrane
RASGRP	Cytosol
EIF1A	Ribosomes
RAP1GAP	Cytosol
I1	Cytosol
FAS	Membrane
NHERF	Cytosol
GBETAGAMMA	Cytosol
RGS4	Cytosol
FAK	Cytosol
SOS	Cytosol
RGS2	Cytosol
RASGRF	Cytosol
MBP	Cytosol
VILIP	Cytosol
cGMP	Cytosol
DCP1	Ribosomes
CALCINEURIN	Cytosol
IR	Membrane
PP1	Cytosol
SRP54	Ribosomes
PP5	Cytosol
DNAJ	ER
NFAT	Nucleus
TALIN	Cytosol
CB1R	Membrane
ARP23	Cytosol
RAP2	Cytosol
RAP1	Cytosol
PDK1	Cytosol
ARF	Vesicles
DARPP32	Cytosol
SYNAPTOPHYSIN	Vesicles
JAK	Cytosol
RAB3	Vesicles
NRCAM	Membrane
SPECTRIN	Cytosol
REELIN	Extracellular
MEF2	Nucleus
PARP	Cytosol
BDNF	Extracellular
DRE	Nucleus
GIRK	Membrane
GLYCINE	Extracellular
SODIUM	Cytosol
FLIP	Cytosol
SEROTONIN	Extracellular
LYN	Cytosol
ZAP70	Cytosol
SEC63P	ER
AMPHIPHYSIN	Cytosol
NT4	Extracellular
MEKK1	Cytosol
MEKK3	Cytosol
MEKK2	Cytosol
bRAF	Cytosol
IP6K2	Cytosol
SRPR	ER
FORKHEAD	Nucleus
GRB2	Cytosol
PAR2	Membrane
PAR1	Cytosol
PIP5K	Cytosol
ARH2	Cytosol
PDGF	Extracellular
MP1	Cytosol
TRYPSIN	Extracellular
MAPKAPK2	Cytosol
DYNAMIN	Vesicles
THC	Extracellular
BCLXL	Mitochondria
CRMP2	Cytosol
BAP31	ER
TRKB	Membrane
TRKA	Membrane
PROFILIN	Cytosol
LTYPECA	Membrane
TRE	Nucleus
GABABR	Membrane
ACTIN	Cytosol
CAMPGEFII	Cytosol
AMPAR	Membrane
IP3R	ER
MYOSINPPASE	Cytosol
HIPPOCALCIN	Cytosol
LRP	Membrane
TFIIB	Nucleus
TFIID	Nucleus
KIR41	Membrane
PRESENILIN	Membrane
KV11	Membrane
KV12	Membrane
ACH	Extracellular
KV14	Membrane
NGF	Extracellular
NAKED	Cytosol
CHOLESTEROL	Membrane
KOPR	Membrane
EZRIN	Cytosol
ALPHA2AR	Membrane
NO	Cytosol
D2R	Membrane
REPS1	Cytosol
NE	Extracellular
NCADHERIN	Membrane
FASL	Extracellular
GRAB	Cytosol
SHP1	Cytosol
APAF1	Cytosol
SAP102	Cytosol
PIP3	Cytosol
PIP2	Cytosol
INTEGRIN	Membrane
COLLAGEN	Extracellular
FER	Cytosol
CYTOCHROMEC	Mitochondria
MINT	Vesicles
LEF	Nucleus
FRAT2	Cytosol
RIN1	Cytosol
PICK1	Cytosol
PDZGEF	Cytosol
DENSIN	Cytosol
AC2	Cytosol
AC1	Cytosol
AC5	Membrane
FOUREBP1	Nucleus
GABAAR	Membrane
MLCK	Cytosol
PCAF	Nucleus
NCS1	Cytosol
SRF	Nucleus
ALPHAACTININ	Cytosol
DAG	Cytosol
PLA2	Cytosol
PICCOLO	Cytosol
DAP	Cytosol
DISHEVELED	Membrane
SYNTAPHILIN	Vesicles
AA	Cytosol
VITRONECTIN	Extracellular
BRADYKININ	Extracellular
A1R	Membrane
RTYPECA	Membrane
FKBP	Cytosol
PDGFR	Membrane
A2AR	Membrane
BETACATENIN	Cytosol
PDE2A	Cytosol
FASCIN	Membrane
GDNF	Extracellular
CALNEXIN	ER
ATF1	Nucleus
ATF2	Nucleus
